XXXXXXXXXXXXXXXXXXXXXXXXX
XP  XXXXXXX            XX
X  XXXXXXX  XXXXXX  XXXXX
X       XX  XXXXXX  XXXXX
X *     XX: XXX        XX
XXXXXX  XX  XXX        XX
XXXXXX  XX  XXXXXXE XXXXX
XXXXXX  XX    XXXX  XXXXX
X !XXX  *     XXXX  XXXXX
X  XXX  XXXXXXXXXXXXXXXXX
X         XXXXXXXXXXXXXXX
X   *            XXXXXXXX
XXXXXXXXXXXX     XXXXX OX
XXXXXXXXXXXXXXX  XXXXX( X
XXXE XXXXXXXXXX  *      X
XXX                     X
XXX         XXXXXXXXXXXXX
XXXXXXXXXX  XXXXXXXXXXXXX
XXXXXXXXXX              X
XX   XXXXX*            EX
XXO  XXXXXXXXXXXXX  XXXXX
XX    XXXXXXXXXXXX  XXXXX
XX          XXXX        X
XXXXE          *         
XXXXXXXXXXXXXXXXXXXXXXXXX
